10.ox
.....oo...
.....o....
o........o
..........
..o....o..
ooo...o...
..o.....o.
..........
oo...ooooo
.o..o....o