10.ox
o..ooo.oo.
.ooo..oo.o
oo.o....oo
.o..o.oo.o
.o...oooo.
....ooo.oo
o...oo...o
oo.o.o.ooo
..oooo..oo
o.oooooooo