10.ox
ooo.oo.ooo
.o...o...o
oo.oo..ooo
ooo.oo.o.o
o.ooooooo.
o..oo...o.
.oo.o....o
o.o....o.o
ooooooo...
.o..ooo...