8.hc
.h...h..
........
.hh.....
......h.
..h....h
..h.....
........
.h.h....
