12_dm
__d___d_____
_______d_d__
d________d__
d___________
____________
____________
_________d__
___d_______d
dd_____d____
____d_______
______d_____
____d_______
