12#wc
#####ww#####
w###w#######
##w#########
####w#####w#
##ww#w######
############
#w###www####
w######w####
########w###
###ww##w####
w##w########
############
