8.ox
.o....o.
..o..o.o
...o....
oooooo..
..o.oo..
..o.....
..o.....
ooo.oo..
